
WE ./image/2.xpm
EA ./image/1.xpm
NO ./image/3.xpm
SO ./image/4.xpm

C 209,183,152

F 115,70,70

        1111111111111111111111111
        1N00000000110000000000001
        1011000001110000000000001
        1001000000000000000000001
111111111011000001110000000000001
100000000011000001110111111111111
1111011111111101111 100000001
11110111111111011101010010001
11000000110101011101010010001
10000000000000001100000010001
10000000000000001101010000001
1100000111010101111101111000111
11110111 1110101 101111010001
11111111 1111111 111111111111